ЫЫЫЫЫЫЫЫЫЫЫЫЫЫЫЫЫЫЫЫЫЫЫЫЫЫЫЫЫЫЫЫЫЫЫЫЫЫЫЫDЫЫЫЫЫЫЫЫЫЫЫЫЫЫЫЫЫЫЫЫЫЫЫЫЫЫЫЫЫЫЫЫЫЫЫЫЫЫЫ
Ы                 Ы            кџкЫ    Ы                                       Ы
Ы                 Ы    ЫЫЫЫЫЫ   к Ы    ЫЫЫЫЫЫЫЫЫЫЫЫЫЫЫЫЫЫЫЫЫЫЫЫЫЫЫЫЫЫЫЫЫЫЫ     Ы
Ы                 Ы    Ы  ЫЫЫ     Ы                                      Ы     Ы
Ы                 Ы    Ы    Ы     Ы                                      Ы     Ы
Ы                 ЫЫЫЫЫЫ    ЫЫЫЫЫ Ы                                      Ы     Ы
Ы                 Ы       Ы к   Ы Ы                                      Ы  ЫЫ Ы
Ы                 Ы  ЫЫЫЫЫЫк    Ы Ы                                      Ыкк ЫЫЫ
Ы                 Ы   к  ЫЫ      кЫ                                      Ы  к ЫЫ
Ы             ЫЫЫЫЫ Ы     Ы ЫЫЫЫЫ Ы                                      ЫЫЫк ЫЫ
Ы             Ы   ЫЫЫ ЫЫЫ Ы Ы Ы   Ы                                      Ы    ЫЫ
Ы Ы        ЫЫ Ы Ы Ы Ык  Ы Ы Ы  ЫЫ Ы                                      ЫЫ ЫЫЫЫ
ЫЫ ЫЫЫЫЫЫЫЫ  ЫЫ Ы ЫЫЫ Ы Ы Ы   к   Ы                                ЫЫЫЫЫЫЫЫ  ЫЫЫ
ЫЫ  к           Ы Ы    к к Ы Ы ЫЫ Ы                                Ы         Ы Ы
ЫЫ к кк ЫЫЫЫЫЫЫЫЫ Ы   Ы Ы Ы  Ы    Ы                          ЫЫЫЫЫЫЫ ЫЫЫЫЫЫЫЫЫ Ы
Ы к к  Ы        Ы Ы   Ы   Ы  Ы    Ы                          Ы      к    Ы     Ы
Ы   кккЫЫЫЫЫ    Ы Ы ЫЫЫЫЫЫЫЫЫЫЫЫЫЫЫ                          Ы  ЫЫк      Ы     Ы
ЫЫЫ к к к  Ы    Ы                 Ы                          Ы ЫЫк к     Ы     Ы
Ы  Ы к к   Ы    ЫЫЫЫЫЫЫЫЫЫЫЫЫЫЫЫЫЫ             ЫЫЫЫ     ЫЫ   ЫЫЫЫ к к ЫЫЫЫЫЫЫЫЫЫ
Ы  ЫЫЫк ЫЫЫЫ         ЫЫЫк к     Ы           ЫЫЫЫ  ЫЫ   Ы  ЫЫЫ Ы  к к кЫ        Ы
Ы    Ы  Ы            ЫЫ кк к     ЫЫЫЫЫЫЫЫЫЫЫЫ      ЫЫЫЫЫ Ы к ЫЫ  ЫЫ   Ы        Ы
Ы    Ык Ы           Ы    к к            Ы к   ЫЫ ккЫ     Ы к     ЫЫ ЫЫЫ        Ы
Ы    Ы кЫЫЫЫЫЫЫЫЫЫЫЫЫ Ы кк к     ЫЫЫЫЫЫ   к     Ы  к ЫЫЫ кк ЫЫЫЫЫЫ ЫЫ          Ы
Ы    Ы                ЫЫк к      Ы    ЫЫЫ к     Ык кЫЫ Ы   Ы                   Ы
ЫЫЫЫЫЫЫЫЫЫЫЫЫЫЫЫЫЫЫЫЫЫЫЫЫЫЫЫЫЫЫЫЫЫЫЫЫЫЫЫЫЫЫЫЫЫЫЫЫЫЫЫЫЫЫЫЫЫЫЫЫЫЫЫЫЫЫЫЫЫЫЫЫЫЫЫЫЫЫЫ