лллллллллллллллллллллллллллллллллллллллллллллллллллллллллллллллллллллллллллллллл
л л                                     л   л   л ллллллл    л     л           л
л л ллллллллллллллл ллллллллллллллллллл л л л л л      л   л ллллл ллллллллллл л
л л               л л                   л л л л л лллл л л л л   л     л   л л л
л ллллллллллллллллл л ллллллллллллллллллл л л л л    л   л л л л л л л   л   л л
л                   л                     л л л л лллллллллл л л л л ллллллллл л
лллллллллллллллллллллллллл лллллллллллллллл л л л л   л   л  л л   л           л
л                        л л                л л л л л   л л  л ллллл ллллллллллл
л лллллллллллллллллллллллл лллллллллллллллллл л л ллллл ллл    л   л           л
л л                                           л     л   л лллллл   ллллллллллл л
л лллллллллллллллллллллллллллллллллллллл лллллллл л л л   л                    л
л                             л л               л л л лллллллллллл ллллллллллллл
лллллллллллллл лллллллллллллл л л    o          л   л            л             л
л            л л            л л             #   ) л лллллллллллл ллллллллллл   D
л лллллллллллл лллллллллллл л л л               л л            л л л           л
л                         л   л л               л лллллллллллл л л л ллллллллллл
л ллллллллллллллллллллллл л л л лллллллл лллллллл л          л л л л           л
л л   л       ллллллл   л л л л   л      л          лллллллл ллл л ллллллллллл л
л л л ллллллл л     л л л   л ллл лллллллллл лллллллл   л        л    лллл   л л
л л л           ллл   л л л л   л                     л л ллллллллллл    л л л л
л л ллллллллллллллллллллл л л л ллллл ллллллллллллллллл л           лллл л л л л
л л          л            л   л       л л             л ллллллллллл л    л л л л
л лллллл ллллл лллллллллл ллллллллллллл ллл лллллллл  л   л   л   л л лллл л л л
л                       л                       л     л л   л   л   л      л   л
лллллллллллллллллллллллллллллллллллллллллллллллллллллллллллллллллллллллллллллллл