ллллллллллллллллллллллллллллллллллллллллDллллллллллллллллллллллллллллллллллллллл
л                 л            ъОъл    л                                       л
л                 л    лллллл   ъ л    ллллллллллллллллллллллллллллллллллл     л
л                 л    л  ллл     л                                      л     л
л                 л    л    л     л                                      л     л
л                 лллллл    ллллл л                                      л     л
л                 л       л ъ   л л                                      л  лл л
л                 л  ллллллъ    л л                                      лъъ ллл
л                 л   ъ  лл      ъл                                      л  ъ лл
л             ллллл л     л ллллл л                                      лллъ лл
л             л   ллл ллл л л л   л                                      л    лл
л л        лл л л л лъ  л л л  лл л                                      лл лллл
лл лллллллл  лл л ллл л л л   ъ   л                                лллллллл  ллл
лл  ъ           л л    ъ ъ л л лл л                                л         л л
лл ъ ъъ ллллллллл л   л л л  л    л                          ллллллл ллллллллл л
л ъ ъ  л        л л   л   л  л    л                          л      ъ    л     л
л   ъъъллллл    л л ллллллллллллллл                          л  ллъ      л     л
ллл ъ ъ ъ  л    л                 л                          л ллъ ъ     л     л
л  л ъ ъ   л    лллллллллллллллллл             лллл     лл   лллл ъ ъ лллллллллл
л  лллъ лллл         лллъ ъ     л           лллл  лл   л  ллл л  ъ ъ ъл        л
л    л  л            лл ъъ ъ     лллллллллллл      ллллл л ъ лл  лл   л        л
л    лъ л           л    ъ ъ            л ъ   лл ъъл     л ъ     лл ллл        л
л    л ъллллллллллллл л ъъ ъ     лллллл   ъ     л  ъ ллл ъъ лллллл лл          л
л    л                ллъ ъ      л    ллл ъ     лъ ълл л   л                   л
лллллллллллллллллллллллллллллллллллллллллллллллллллллллллллллллллллллллллллллллл