                  =========================           ===========               
                  |                       |           |         |               
==================| ===================== ============= ======= |               
|                 | |                   |     |             | | |               
| =============== | | ================= | | |   | ========= | | |               
|               | | | |   |   |   | |   | | =======         | | ==============  
================= | | | |   | | |   | |   |   |     ========| |              |  
     |            | | | ===== = ===== ======= | ====| |   | | ============== |  
     | =========  === | |         |     |     | |   |   |   |                |  
     | |o      |      | | ============= | === | | | | ===== ======= ==========  
     | ======  | ====== | |           | |   | | | | | |   |       | |           
     |       | | |      | | =========== === | | | |     | |       | |           
============ | | ======== | |   )   |       | | ========= |       | |           
D          | | |   |      | | ===== |       | |        |  |       | |           
| ========== | === | ====== | |   | ========= =======  |= ========= ======      
| |          |   | | |      | | | |                |   |        |        |      
| |  =========== | | | ====== | | |=============== | = ======== | ====== |      
| |            | | | |        | | |                | | |      |    |   | |      
| ====== ===== === | ========== | | ================ === === ===== | | | |      
|      | |   |     | |          | | |     |              | | |   | | |   |      
======== | | ======= | ========== | ===   === ============ | |   | |==========  
    |    | |           |          |   |     |              | |   | |         |  
    |  === |===========| =========== =|     | ============== |   | ========= |  
    |      |           |              |     |                |   |           |  
    ========           ================     ==================   =============  