/==============================================================================\
| |                                     |   |   | =======    |     |           |
| | =============== =================== | | | | |      |   | |==== =========== |
| |               | |                   | | | | | ==== | | | |   |     |   | | |
| ================= | =================== | | | |    |   | | | | | | |   |   | |
|                   |                     | | | | ========== | | | | ========= |
|========================= ================ | | | |   |   |  | |   |           |
|                        | |                | | | | |   | |  | |==== ==========|
| ======================== ================== | | ===== ==|    |   |           |
| |                                           |     |   | |=====   =========== |
| ====================================== ======== | | |   |                    |
|                             | |               | | | ============ ============|
|============= ============== | |    o          |   |            |             |
|            | |            | |                 ) | ============ |============ D
| ============ ============ | | |               | |            | | |           |
|                         |   | |               | ============ | | | ==========|
| ======================= | | | ======== ======== |          | | | |           |
| |   |       |=====|   | | | |   |      |          ======== === | =========== |
| | | |====== |     | | |   | === ========== ========   |        |    ===|   | |
| | |           |=|   | | | |   |                     | | ===========    | | | |
| | ===================== | | | ===== ================= |           |=== | | | |
| |          |            |   |       | |             | =========== |    | | | |
| ====== ===== ========== ============= === ========  |   |   |   | | ===| | | |
|                       |                       |     | |   |   |   |      |   |
\==============================================================================/