ллллллллллллллллллллллллллллллллллллллллDллллллллллллллллллллллллллллллллллллллл
л                                                                              л
л                                                                              л
л                                                                              л
л                                                                              л
л                                                                              л
л                                                                              л
л                                                                              л
л                                                                              л
л                                                                              л
л                                                                              л
л                                                                              л
л                                                                              л
л                               Level 4                                        л
л                                                                              л
л                                                                              л
л                                                                              л
л                                                                              л
л                                                                              л
л                                                                              л
л                                                                              л
л                                                                              л
л                                                                              л
л                                                                              л
лллллллллллллллллллллллллллллллллллллллллллллллллллллллллллллллллллллллллллллллл