лллллллллллллллллллллллллллллллллллллллллллллллллллллллллллллллллллллллллллллллл
л                                    лпл                                       л
л                               лллллл-лллллл                                  л
л                               л///////////л                                  л
л                               л/////л///л/л                                  л
л                               л///////////л                                  л
л                               лл///////л//л                                  л
л                               лллллл-лллллл                                  л
л                                 лл//////л                                    л
л                                 л//л////л                                    л
л                                 л////л//ллл                                  л
л                                 ллллллл   л                                  л
л                 ллллллллллллллллллллллллл л                                  л
л                 л                  лл   л л                                  л
л                 л лллллллллллллл   лл л л л                                  л
л                 лл#                лллл лллллл                               л
л                 л   лллллллллллл    )    0#л##ллллллл                        л
л                 л лл    л          ллллллллл  #######л                       л
л                 л л   л л  ллллл# #ллл#  ##         #л                       л
л                 л л#  л л  л   л# #ллP        #  #  #л                       л
л                 л л#  л л  л л л     л     ##  #    #л                       л
л                 л л###л    л л лллллллллл #л## #  # #л                       л
л                 л лллллллллл л лллoлллллл #л#     ъ #л                       л
л                 л            л     л0(    #л##  #  ##л                       л
ллллллллллллллллллллллллллллллллллллллллDллллллллллллллллллллллллллллллллллллллл