лллллллллллллллллллллллллллллллллллллллллллллллллллллллллллллллллллллллллллллллл
л                                                                              л
л                                     п                                        л
л                                                                              л
л                                                                              л
л                                                                              л
л                                                                              л
л                                                                              л
л                                                                              л
л                                                                              л
л                                                                              л
л                                                                              л
л                                                                              л
л                                                                              л
л                                                                              л
л                                             лл                               л
л                                            л##ллллллл                        л
л                                      ллллллл  #######л                       л
л                                      л#  ##         #л                       л
л                                     лP        #  #  #л                       л
л                                      л     ##  #    #л                       л
л                                    лллллл #л## #  # #л                       л
л                                    лллллл #л#     ъ #л                       л
л                                    л0(    #л##  #  ##л                       л
ллллллллллллллллллллллллллллллллллллллллDллллллллллллллллллллллллллллллллллллллл